1111111111111
1C0000P000001
1001010111001
1001C100C1001
1001110111001
1000C101C0001
100001C111001
1C00000000EC1
1111111111111
